11111111111111111111111111
1000000000000C1C00000000C1
1C111111101111111011111111
11111000000000000000000001
10000011111100011111111101
1011111C000001000C11111101
10100011111111111111111101
10101C00000C100000000000C1
10101111111111011111111111
1E1001111C00000000000000C1
11110000001111111111111101
1C000111100001111C00000001
11111111111011111111111111
10C0010000C00000000C000001
10111101111111111100000001
1C00000111C000C000C1111111
11111100000111111C11111111
10000001111100000000000001
11110101111101111100011111
1000C10000C00100C0010C0001
10111111111111111111111101
1P000000000000V00000000001
11111111111111111111111111
