1111111111111
1P0000E000CT1
1111111111111