1111111111111
10C1000000CC1
1011011111101
1P0001E000CC1
1111111111111
