1111111111
1000000001
1C00000001
1C00000001
1C00000001
1C00000001
1C00000001
1C000000E1
1C11111111
1P00000001
1111111111
