1111111111111111111111111111111111111111111111111111111111111111111111111111
1000000000000000000000000000000000111111111111000000000000011000000000000001
10000000000000000000000000000000001111111111110000000000000PC000000000000001
1000000000000000000000000000000000111111111111000000000000000E00000000000001
1000000000000000000000000000000000000000000000000000000000000000110000000001
1000000000000000000000000000000000000000000000000000000000000000110000000001
1000000000000000000000000000000000000000000000000000000000000000110000000001
1000000000000000000000000000000000000000000000000000000000000000110000000001
1000000000000000000000000000000000000000000000000000000000000000110000000001
1000000000000000000000000000000000000000000000000000000000000000110000000001
1000000000000000000000000000000000000000000000000000000000000000110000000001
1000000000000000000000000000000000000000000000000000000000000000110000000001
1000000000000000000000000000000000000000000000000000000000000000110000000001
1000000000000000000000000000000000000000000000000000000000000000110000000001
1000000000000000000000000000000000000000000000000000000000000000110000000001
1000000000000000000000000000000000000000000000000000000000000000110000000001
1000000000000000000000000000000000000000000000000000000000000000110000000001
1000000000000000000000000000000000000000000000000000000000000000110000000001
1000000000000000000000000000000000000000000000000000000000000000110000000001
1000000000000000000000000000000000000000000000000000000000000000110000000001
1000000000000000000000000000000000000000000000000000000000000000110000000001
1000000000000000000000000000000000000000000000000000000000000000110000000001
1000000000000000000000000000000000000000000000000000000000000000110000000001
1000000000000000000000000000000000000000000000000000000000000000110000000001
1000000000000000000000000000000000000000000000000000000000000000110000000001
1000000000000000000000000000000000000000000000000000000000000000110000000001
1000000000000000000000000000000000000000000000000000000000000000110000000001
1000000000000000000000000000000000000000000000000000000000000000110000000001
1000000000000000000000000000000000000000000000000000000000000000110000000001
1000000000000000000000000000000000000000000000000000000000000000110000000001
1000000000000000000000000000000000000000000000000000000000000000110000000001
1000000000000000000000000000000000000000000000000000000000000000110000000001
1000000000000000000000000000000000000000000000000000000000000000110000000001
1000000000000000000000000000000000000000000000000000000000000000110000000001
1000000000000000000000000000000000000000000000000000000000000000110000000001
1000000000000000000000000000000000000000000000000000000000000000110000000001
1000000000000000000000000000000000000000000000000000000000000000110000000001
1000000000000000000000000000000000000000000000000000000000000000110000000001
1000000000000000000000000000000000000000000000000000000000000000110000000001
1000000000000000000000000000000000000000000000000000000000000000110000000001
1000000000000000000000000000000000000000000000000000000000000000110000000001
1000000000000000000000000000000000000000000000000000000000000000110000000001
1000000000000000000000000000000000000000000000000000000000000000110000000001
1000000000000000000000000000000000000000000000000000000000000000110000000001
1000000000000000000000000000000000000000000000000000000000000000110000000001
1000000000000000000000000000000000000000000000000000000000000000110000000001
1000000000000000000000000000000000000000000000000000000000000000110000000001
1000000000000000000000000000000000000000000000000000000000000000110000000001
1000000000000000000000000000000000000000000000000000000000000000110000000001
1000000000000000000000000000000000000000000000000000000000000000110000000001
1000000000000000000000000000000000000000000000000000000000000000110000000001
1000000000000000000000000000000000000000000000000000000000000000110000000001
1000000000000000000000000000000000000000000000000000000000000000110000000001
1000000000000000000000000000000000000000000000000000000000000000110000000001
1000000000000000000000000000000000000000000000000000000000000000110000000001
1000000000000000000000000000000000000000000000000000000000000000110000000001
1000000000000000000000000000000000111111111111000000000000000000001100000001
1111111111111111111111111111111111111111111111111111111111111111111111111111
