11111111111111111111111111111111111
10000000000000000000000000000000001
100000000000000000P0000000000000001
10000000000000000000000000000000001
10001111000011110011111111111100001
10001111000011110011111111111100001
10001111000011110011110000111100001
10001111000011110011110000111101001
10001111111111110000000011110110111
1000111111111111000000111101000E001
10000000000011110000111100010000001
100C0000000011110011110000111111111
10000C00000011110011111111111100001
10000C00000011110011111111111100001
10000000000000000000000000000000001
10000000000000000000000000000000001
10000000000000000000000000000000001
11111111111111111111111111111111111
