111111111111111111111111
1P00000011111110000000C1
11111110111E111011111111
1C0001000000000011111111
101111111111111111111111
1000C1C000000100000000C1
101111111111010111111111
1000V0000111010111100001
1111111101C1010000001101
1C0000000101C11111111101
111111110001111111111101
11111111000000C000000001
111111111111111111111111
