1111111111
10000000E1
1000000001
10000000V1
1000000001
1000000001
10C0000001
1000000001
1P00000001
1111111111
