1111111111111
10V1000000CV1
1011011011101
1P0001E000CV1
1111111111111
