111111
1P10C1
1C10V1
1E0001
1010V1
1V10C1
111111
