11111111111111111111111111111111111
10000000V00001C00000000000000000001
10V00000000001V00000C00000000000001
1000V000000000000000000000000000001
1000111100001111V01111111111110EV01
10001111000011110011111111111100001
100011110000111100111100VC111100001
10001111000V11110011110000111100001
10001111111111110000000011110000001
1000111111111111C00000111100000P001
10000000C00V11110000111100000000001
100C000000001111001111VC00111100001
10000C00000011110011111111111100001
10000C00000011110V11111111111100001
10000V0000V000000C000000000000V0001
1000000000010000000000C000000000001
10000000000100V000000000000000000C1
11111111111111111111111111111111111
