1111111111
1V00C000E1
100C000001
100V0000V1
1000000001
1000000C01
10C0000001
1000000001
1P0V0000V1
1111111111
